# # # # # O # # #
# #             #
# @    #  #     #
#      #  # #   #
#   #   $ # # # #
#      # #  #   #
#  #   #  # # # #
#               #
# # # # # # # X #